11111111111111111
1P000000000000C01
10101C10101C10101
10000C000000000C1
101C1010101010101
10000C00000000001
1010101C101010101
1000000S000000001
101010101C1010101
10000C00000000001
101C10101C1010101
10000C00000000001
101S10101E1C1S101
10C00000C000000S1
11111111111111111
