11111111111111111111111111111111
11111111111111111111111111111111
11111111111111111111111111111111
11111111P0000000000000S111111111
11111111010101010101010111111111
1111111100C0C0C0C0C0C00111111111
11111111010101010101010111111111
1111111100C0C0C0C0C0C00111111111
11111111010101010101010111111111
1111111100C0C0C0C0C0C00111111111
11111111010101010101010111111111
1111111100C0C0C0C0C0C00111111111
11111111010101010101010111111111
11111111S0000000000000E111111111
11111111111111111111111111111111
11111111111111111111111111111111
11111111111111111111111111111111
11111111111111111111111111111111
