1111111111111111111111111111
1111111111111111111111111111
1P000000000000000000000000S1
1011C010C110C110101CC1011101
101010101CC01CC0101CC101CC01
1011C010C1CS1CC01011C1011C01
101CC010CC101CC0101C1101CC01
101CC01011C0C110101CC1011101
1S000000000000000000000000E1
1111111111111111111111111111
