11111111111111111
1P000000000C00CC1
10001C00000010001
100C1CC101C0100C1
10111011C11011101
10100C00000000101
10000000100000001
1000000C0C0000001
10000010101000001
100000SC0CS000001
10000C0S1S0000001
10100000000000101
10111011C11011101
10S01SC101C010001
10SS1000S00010SC1
1SSSSSSSSSSSSSSE1
11111111111111111
