11111111111111111
1P000000000C10C01
10111C10101110101
10000C000000001C1
10111111101011101
10000C00000000001
1111111C101111101
1000000S001000101
100000001C101C101
10000C00001010101
101C00000C0010001
10100C00001111111
101S00001E0C0S1C1
10C00000C000000S1
11111111111111111
