11111111111111111111111111111111
111P00000000000000000000000SC111
11101C111111111111011111110CS111
11101010000000000C01C00000000111
11101010111111111101011111100111
1110101010000000010101C000000111
11101010101111110101010111110111
111010101CCCC00101010101C0000111
111010101CCCC1010101010101000111
111010101CCCC1010101010101000111
111010100CCCC10101010101C0000111
11101011111101010101010111110111
1110100000000101010101C000000111
11101111111111010101011111100111
1110C000000000010101C00000000111
1110111111111111C1011111110CS111
111000000000000000000000000SE111
11111111111111111111111111111111
