11111111111111111111111111111111
1P0000000000000000000000000000S1
10000000000000000000000000000001
101C1011C010C110C110101CC1011101
101C101010101CC01CC0101CC101CC01
10111011C010C1C01CC01011C1011C01
10CC101CC010CC101CC0101C1101CC01
10CC101CC01011C0C110101CC1011101
10000000000000000000000000000001
10000000000000000000000000000001
10111011C011C0C1C0C11C01C1011101
10CC101010101010101CCC01C101CC01
10111011C011C011101C1C01C1011C01
101CC01CC01C101C101CC101C101CC01
1011101CC01C101C10C11C0111011101
100000000000000000000000000000S1
1S000000000000000000000000000SE1
11111111111111111111111111111111
