1111111111111111111111111111111111111111111111111111111111111111
1111111111111111111111111111111111111111111111111111111111111111
1111111111111111111111111111111111111111111111111111111111111111
1111111111111111111111111111111111111111111111111111111111111111
1P000000000000000000000000000000000000000000000000000000000000S1
101C10111011C011C0C1C0C11C01C10111000011C010C110C110101CC1011101
101C10CC101010101010101CCC01C101CC00001010101CC01CC0101CC101CC01
101110111011C011C011101C1C01C1011C000011C010C1C01CC01011C1011C01
10CC101CC01CC01C101C101CC101C101CC00001CC010CC101CC0101C1101CC01
10CC1011101CC01C101C10C11C0111011100001CC01011C0C110101CC1011101
1000000000000000000000000000000000000000000000000000000000000001
100CCC0CCC0CCC0CC101C101CC101110001110111011101110CCC0CCC0CCC001
100111011101110CC101C101CC101CC000CC101010CC10CC1011101110111001
100CCCSCCCSCCC0CC101C1011C1011C00011101S101110C110CCCSCCCSCCC001
1001110111011101C101C101C1101CC0001CC010101CC0CC1011101110111001
100CCC0CCC0CCC0C1C011101CC101110001110111011101110CCC0CCC0CCC001
1000000000000000000000000000000000000000000000000000000000000001
1001CC10C1C011C0C1C0C1C0S0S0S0C1C01CC011C0111011C0C1C0C1C01CC101
1001CC10101010101010101001C10010101CC010101CC01010101010101CC101
10011C10111011C01S101S10SC1CS011101CC01S1011C011C01110111011C101
1001C1101C1010101010101001C1001C101CC010101CC01C101C101C101C1101
1001CC101C1011C0C1C0C1C0S0S0S01C10111011C011101C101C101C101CC101
1000000000000000000000000000000000000000000000000000000000000001
100CCC0CCC0C11C0C1C0C1C011C0001CC01C10C1101C1000101010CCC0CCC001
100111011101CCC0101010101010001CC01C101CC01C10001010101110111001
100CCCSCCC01C1C01S101S101S10001CC01C101CC011C000101010CCCSCCC001
100111011101CC10101010101010001CC01C101CC01C1000C0C0C01110111001
100CCC0CCC0C11C0C1C0C1C011C00011101110C1101C1000101010CCC0CCC001
1000000000000000000000000000000000000000000000000000000000000001
10C110C1C0CCC01CC0C1C01CC10C11C00111000C10C1C01CC011C01C10C1C001
101CC01010CCC01CC010101CC101CCC0010100011010101CC010101C10101001
10C1C01S10CCC01CC01S1011C101C1C001S1000C1011101CC011C01110111001
10CC101010CCC01CC010101C1101CC100101000C101C101CC01CC01C101C1001
1011C0C1C011101110C1C01CC10C11C001110E0C101C1011101CC01C101C1001
1S000000000000000000000000000000000000000000000000000000000000S1
1111111111111111111111111111111111111111111111111111111111111111
