11111111111111111
1P000000000010C01
101C10101C1011111
10000C000000000C1
101S1010101C1S101
10C00000C000000E1
11111111111111111
