11111111111111111
1P000000000010C01
101C10101C1010111
10000C000000000C1
101S1010101C1S101
100C00000C00000E11
11111111111111111
