11111111111111111111111111111111
11111111111111111111111111111111
111111P0001001C1C1001000S1111111
111111001C10000100001C1001111111
11111101111011010110111101111111
111111001000C10001C0001001111111
11111100001111010111100001111111
11111100100100010001001001111111
11111101110101010101011101111111
11111100100001010100001001111111
11111100001111010111100001111111
11111100100001010100001001111111
11111101111000010000111101111111
111111001C10110101101C10S1111111
111111S00010C10101C0100SE1111111
11111111111111111111111111111111
11111111111111111111111111111111
11111111111111111111111111111111
